Dutch vocab :

daarnaast : besides 
daarna : afterwards

aantal : number / number of

aantal Franchisers : number of Franchisers

hebben : to have

gisteren  : yesterday 

laten : let

zien : see

erg : very

enthousiast : enthusiastic

pas op : beware 
mes : knife

met : with 

van : from / off /with by 

mag ( from mogen ): may / allow

deze : this (mag ik deze dans van u)

mevrouw : lady
meneer / heer : gentleman
betaalt : pays  (Deze mevrouw betaalt alles)
wil :want

geen dank : no thanks

vaak : often /frequently : kom je hier vaak ( do you come here often )
kom : come
je : you
vaak : often
hier : here

mis : miss ( Ik mis ye)

hou van : love (Ik hou van u / je / jou)

ga weg : Go away

Gefeliciteerd : congratulations
Van harte : heartiest
verjaardag : birthday

een (with dots ) : one 
taal : language

wie wachten we op : Who are we waiting for ? 
wie : who
wacht : wait
op : for, on, at , in 


sturen : send (kun je me de link sturen : Could you send me the link please ?)

vind : find (I am not finding it L: Ik vind het niet)

scherp : sharp 
pas op : beware 
mes : knife
snijdt : to cut / slice
Het mes snijdt in je vinger  - the knife slice in your finger ???


Er : there
zit : sit
aan : to, in, about , on
Er zit bloed aan met mes : There sits blood on the knife ???

daar : there (for direction)
hun : their (possession )
er : normal there, like there is this boy on the road
----------------------------------------------
Words related to zit : 
zitten : sit
staan : stand
liggen : lie   ( These words are used for describing the state of objects, like the pen lies on the table. The glass stands on the table)


auto : car
deur : door
hoor ( hoort / hooren ) : to hear

haar : hair.. also means 'her' in some cases
eens : once (kam je haar eens : comb your hair once)

nodig : need,  requirement (Ik heb een kam nodig)
hoef : also means need or requirement, but hoef is a verb and nodig is a noun
zie : see

spelen : play (De kinderen spelen met de bal : The children play with the ball)
gooien : throw (Ze gooien met de bal / They throw the ball)
vangen : catch : Ze vangen de bal 
tegen : against
been : leg (also means bone)
beenen : legs (plural of leg)
benderen : bones (plural of bone)    Een bal tegen mijn been : A ball against my leg

legt : to lay/ to put  Leggen : leg, legt   (De kip legt een ei)
Ei  : egg
Eieren : Eggs (Uit dat ei komt een jonge kip : From that egg comes out a young chicken.)

jonge : young
jongen : boy 
jongens : noys
jongeren : young people

graag : like / sure (90/10 %)
mansen : people
eten : food
onze : our + us (Onze kip is lekker)

bijt : bite (Ik bijt op mijn lip)
pijn : pain (Dat doet pijn ?) Does that pain ?
dik : thick / fat (Je lip is dik)

Ziet er : Looks
geef : gave (geven, geeft)   : I geev, Zij geeft, We / Ze geven
gaa / gaan / gaat : go , forms of go : Ik ga, Ze gaat : She goes
ken : know : Ken je de eend : do u know the duck (kennen, kent)
soep : soup

Loop : walk
zwemt : swim
hoor : hear
aanpassingen : modifications
nog : yet 

bereikbaar : accessible
tussen : between
ongemak : discomfort
afdeling : department

blaaderen : leaves, blaad : leaf
liever : rather / prefer

Groot : big

Grote : very big

heel : complete
hele : very complete

duur : expensive
dure : very expensive

wit : white
witte  : very white

druk : busy
   if druk is a verb , then it means "press / print". If it is in b/w it is a verb.
   If not in the posn of the verb it is a noun. When a noun, it means busy or crowded
drukke : very busy

klein : small
kleine : very small

ruimen : cleans
maar : only / but 


jurk : dress, jurken : dresses
bril : glass, brilen : glasses
hemd : shirt, hemden : shoes
broek : pants
jas : coat, jassen : coats
pak : suit
schoen : shoe
trui : sweater, truien : sweaters
sok : sock, sokken : socks
rok : skirt, rokken : skirts
hoed : hat
kleren : clothes
tas : bag
klomp : klog
ondergoed : underwear

lang : tall
korte : short
langzame : slow
snel : fast

staart : tail
haar :her (also hair in some cases)

zijn : are, but also 'its' (Het schildpad zwemt naar zijn baby) -- the turle swims towards its baby

stopt : stops , somewhere 'putting' also
eerder : sooner
waarom : why
proef : trial, (can be used for tasting, like trying everything in menu)

yard : tuin
blijven  : stay
nieuwe : new
dingen : things
leren : to learn
weigert : refuses
wachten : to wait
op mij : on me
grootmoeder : grandmother

olifante : elephant
parde : horse
spider : spin
birds : vogels
konijn : rabbit
hert : Deer

zwak : weak / zwakken mannen : weak men
slecht : bad
zware / zwaar: heavy
sterk : strong
leuk / leuke : nice
moeilijk : difficult
makkelijk : easy
volle : full / vol : full
belangrijke : important
goedkope : cheap
leeg : empty
verse : fresh / vers : fresh
duur : expensive
rustig : quiet
zoals : like / as
interessante : interesting 
cold : koud
schoon / schone : clean
net zoals : just like
zoals : like
kort / korte : short
kliene : small / groot : big
snel : fast
licht : light
duur / dure : expensive 

rekening : bill / cheque
al : ask / asked
al om de : ask for the
gevraagd : already
vrienden : girlfriend
jealous : jaloers

koos  : choose
slag : work
aan de slag : to work


hun : their / them 
hen : them 
ze : them / Ik eet ze : I eat them
ons : Us / De man kent ons

kleuren : colors

blouse : blouse

pak : business suit for men / package / packet
    : when it is a verb, it means grab, sieze, catch, grip, bite
	
somehow : ergens    (somehow, somewhere, anywhere)

sometimes : soms, wel eens	

always : altijd , steeds

never : nooit

often : vak, dikwijls

usually : meestal (also mostly)
        : doorgaans - generally / usually
		
doorgaans : generally, usually, persue, going, go though etc
		
		

want : because 
dus : so



Heeft er iemand : Does anyone have
iemand : anyone / someone

stukje : piece
money : geld
----------------------------------------------------------------------------------------
iets : something
iemand : someone
genoeg : enough, sufficient
iedereen : everyone
iedere : every
verschillende : various
weinig : not much / not many
weinige : few 
enige : a few
enige : only, a few, some
enkele : some / few
allerlei : all kinds of
veel : many, lots of
Sommige : some
iedere : every
wat : something, some, that
always : altijd
heel : very
erg : very
meestal : usually
veel : much / many
evrey : iedere / elke/ elk
enkel : single
everyone : iedereen
nergens : nowhere
ergens : somewhere / anywhere / somewhat



GEEN ENKEL : NOT A SINGLE

elke : every

paar :  a few

Ieder : each, every, any

geen enkele : not a single

voet : foot
doel : goal, target
riem : belt
wiel : wheel
duim : thumb

mogelijk : possible


tijdens : during
achter : behind
tegen : against
vanwege : because of
Naast : next to/ besides
Na : after
door : through
aan : on , to : aan hem : to him

omdat : because
veranderd : changed
gesprek : conversation
minuten : minutes


